1110001111
1010101111
101s101111
1011100001
1000001101
1011111111
1010000001
1010110101
1000110101
1111110101