1111111111
1111100001
1111101111
1111101111
s000000001
1111101111
1111101111
1111101111
1111111111
1111111111