0000001000
0s10000000
0000000000
0000000000
0001110000
0000000000
0000000000
0000000000
0000000000
0000000000