1111111111
1000000001
1110000001
1000000001
1010000001
1011100001
1000100001
1010100001
11s0100001
1111111111