1111111111
s000000101
0101010101
0001010101
0111010101
0000010101
1111110101
0000000101
0111111101
0000000001