1111111111
1110111101
1000000101
1110111101
1110111101
1110111001
1000101011
1110101011
1s00000001
1111111111