1111111111
1111111111
1111110001
1111110101
1111110101
s010000100
1010111101
1000000001
1111111111
1111111111